5
# # # # #
# E U . #
# . # . #
# # . R #
# # # # #
#
