15
# # # # # # # # # # # # # # #
# . . . . . . . . . . . . . #
# . . . . . . . . . . . . . #
# . . E . . . # # # . . . . #
# . . # # # . . . # . . . . #
# . . . . . . # . . . . . . #
# . . . . . . # . . . . . . #
# . . . . . . # . . . . . . #
# . . . . # . # . . . . . . #
# . . . . # R # . . . . . . #
# # . . . # . # . # # . . . #
# . . . . . . # U . . . . . #
# . # # # # # # . . . . . . #
# . . . . . . . . . . . . . #
# # # # # # # # # # # # # # #
#
