15
# # # # # # # # # # # # # # #
# E . . . . . . . . . . . U #
# . . # # . . # # . . . . . #
# . # . . . # . . . . . . . #
# . # . . . . # . . . . . . #
# . # . . . . . # . . . . . #
# . . # # . # # . . . . . . #
# . . . . . . . . . . . . . #
# . # # . # . # . . # . . . #
# . . # # # # . # # . # . . #
# . # # . # # . # # . # . . #
# . # . . # # . # # . # . . #
# . # # . # . # . . # . . . #
# . . . . . . R . . . . . . #
# # # # # # # # # # # # # # #
#
